2221111111
2        1
2311131  1
1        1
5  1  1133
5  1  1  6
1  1311  3
3       11
1  1     4
1551114444